0000000000000
0000003000000
0000032300000
0000321230000
0003221223000
0032211122300
0322115112230
0032211122300
0003221223000
0000321230000
0000032300000
0000003000000
