0000000000000
0000000000000
0333333333330
0311111111130
0311111111130
0311111111130
0311111111130
0311111111130
0333333333330
