1222222222222
1122222222222
1112222222222
1111222222122
1111122222222
1111112222222
1111111222222
1111111122222
1121111112222
1111111111222
1111111111122
1111111111112
