0000000000000
0000000000000
0555055505550
0530000000350
0510000000150
0511111111150
0511111111150
0511111111150
0511111111150
0511111111150
0511111111150
0511111111150
0533333333350
