0000000000000
0000002000000
0000002000000
0000002000000
0000002000000
0000002000000
0000002000000
0000002000000
0000002000000
0000222220000
0000002000000
0000002000000
